17 32
9 15
9   9  9  9  9   9    9   9   9   7   7    220 7   7   9   9   9 
9   9  9  9  9   9    9   9   9   7   4    4   4   7   9   9   9
9   9  9  9  9   9    9   9   9   216 4    4   4   219 9   9   9
215 7  9  9  9   9    9   9   9   7   4    4   4   7   9   9   9
4   7  9  9  9   9    9   9   9   7   4    4   4   7   9   9   9
4   7  9  7  7   222  7   223 7   7   4    4   4   7   7   7   7
4   7  9  7  4   4    4   4   4   4   4    4   4   4   4   4   7
4   7  9  7  4   4    4   4   4   4   4    4   4   4   4   4   7
4   7  9  7  4   4    4   4   4   4   4    4   4   4   4   4   7
4   7  9  7  224 7    225 7   226 7   7    4   4   4   7   44  9
4   7  9  9  9   9    9   9   9   9   7    4   4   4   7   44  9
4   7  7  7  7   7    7   7   7   7   7    4   4   4   7   44  9
4   4  4  4  4   4    4   4   4   4   4    4   4   4   219 231 9
4   4  4  4  4   4    4   4   4   4   4    4   4   4   7   9   9
214 7  7  7  7   7    7   7   7   7   7    4   4   4   7   9   9
9   9  9  9  9   9    9   9   9   9   213  4   4   4   7   9   9
9   9  9  9  9   9    9   9   9   9   7    4   4   4   7   9   9
9   9  9  9  9   9    9   9   9   9   212  4   4   4   7   9   9
9   9  9  9  9   9    9   9   9   9   211  4   4   4   7   9   9
9   9  9  9  9   9    9   9   9   9   7    4   4   4   7   9   9
9   9  9  9  9   9    9   9   9   9   7    4   4   4   7   9   9
9   9  9  9  9   9    9   9   9   9   210  4   4   4   7   9   9
9   9  9  9  9   7    7   227 227 227 7    4   4   4   7   9   9
9   9  9  9  9   7    4   4   4   4   4    4   4   4   7   9   9
9   9  9  9  9   209  4   4   4   4   4    4   4   4   218 9   9
9   9  9  9  9   7    7   7   7   7   7    4   4   4   7   9   9
9   9  9  9  9   9    9   9   9   9   208  4   4   4   7   9   9
9   9  9  9  9   9    9   9   9   9   7    4   4   4   7   9   9
9   9  9  9  9   9    9   9   9   9   207  4   4   4   217 9   9
9   9  9  9  9   9    9   9   9   9   206  4   4   4   7   9   9
9   9  9  9  9   9    9   9   9   9   205  4   4   4   7   9   9
9   9  9  9  9   9    9   9   9   9   7    7   221 7   7   9   9